3D背景|3d background
紅色背景|red background
葉背景|leaf background
灰色背景|grey background
藍色背景|blue background
水色背景|aqua background
深色背景|dark background
背景文字|background text
棕褐色背景|tan background
標誌背景|flag background
網格背景|grid background
蕾絲背景|lace background
玫瑰背景|rose background
白色背景|white background
粉紅色背景|pink background
黑色背景|black background
棕色背景|brown background
綠色背景|green background
米色背景|beige background
心臟背景|heart background
照片背景|photo background
格子背景|plaid background
水果背景|fruit background
兔子背景|bunny background
黃色背景|yellow background
紫色背景|purple background
橙色背景|orange background
花卉背景|floral background
菱形背景|argyle background
虛線背景|dotted background
氣泡背景|bubble background
棕褐色背景|sepia background
銀色背景|silver background
火熱的背景|fiery background
軟圖背景|sofmap background
簡單的背景|simple background
模糊的背景|blurry background
條紋背景|striped background
閃光背景|sparkle background
彩虹背景|rainbow background
馬賽克背景|mosaic background
鑲板背景|paneled background
漸變背景|gradient background
抽象背景|abstract background
飛濺背景|splatter background
雙色調背景|two-tone background
圓點背景|polka dot background
半色調背景|halftone background
圖案背景|patterned background
旭日形背景|sunburst background
爪印背景|paw print background
雪花背景|snowflake background
蜂窩背景|honeycomb background
薰衣草背景|lavender background
方格的背景|checkered background
單色背景|monochrome background
透明背景|transparent background
淺藍色背景|light blue background
淺棕色背景|light brown background
未完成的背景|unfinished background
多彩多姿的背景|multicolored background
以食物為主題的背景|food-themed background
帶彩色背景的灰度|greyscale with colored background
